C 139,0,12
F 64,64,64

NO textures/wolfenstein/mossy.xpm
SO textures/wolfenstein/color_stone.xpm
WE textures/wolfenstein/eagle.xpm
EA textures/wolfenstein/grey_stone.xpm
        1111111111111111111111111
        1110000001100000100000001
        1111000001110000000000001
        100100000000000000N000001
1111111110110000001110000000000001
110000000011000001010111110111111
111100000001110101000000100011101
11000000001111010101010010001  1   
110000001100010100000000010001
10000000001100001100000010001
1000000000000011010100100011
110000011101010100010111100011
1000001111010101111011111001
11111111 1111111 1111111111111

//m3awdin
//F 64,64,64,, lfasila
