NO textures/wolfenstein/mossy.xpm
SO textures/wolfenstein/color_stone.xpm
WE textures/wolfenstein/eagle.xpm
EA textures/wolfenstein/grey_stone.xpm

C 144,224,239
F 204,197,176

        1111111111111111111111111
        1010000001100000000000001
        1111000001110000000000001
        1001000000000000000000001
1111111110110000001110000000000001
110000000011000001110111110111111
111101111111110111000000100011111
11110111111111011101010010001
110000001101010111000000010000
100000000000100001100000010001
10000000000000011010100100011
11000001110101010111011110N0111
111101111111010111101111000001
11111111 1111111 1111111111111