C 139,0,12
F 64,64,255

NO textures/wolfenstein/mossy.xpm
SO textures/wolfenstein/color_stone.xpm
WE textures/wolfenstein/eagle.xpm
EA textures/wolfenstein/grey_stone.xpm

1111111111111111111
1000000000W00000001
1111111111111111111

