C 139,0,0
F 64,64,64
NO textures/wolfenstein/mossy.xpm
SO textures/wolfenstein/color_stone.xpm
WE textures/wolfenstein/eagle.xpm
EA textures/wolfenstein/grey_stone.xpm
        1111111111111111111111111
        1110000001100000100000001
        1111000001110000000000001
        1001000000000000000000001
1111111110110000001110000000000001
110000000011000001110111110111111
111100000001110101000000100011101
11000000001111010101010010001  1   
110011111100010100000000010001
1000001N101100001100000010001
10000001000000011010100100011
110000011101010100010111100011
1000001111010101111011111001
11111111 1111111 1111111111111